0000000000000000000000111
0000000000000000000000101
0000000000000000000000101
0000000000000000000000101
0000000000000000000000101
0000000000000000000000101
0000000000000000000000101
0000000000000000000000101
0000000000000000000000101
0000000000000000000000101
0000000000000000000001101
0000000000000000000001001
0000000000000000000001001
0000000000000000000001001
0000000000000000000001001
0000000000000000000001101
0000000000000000000000101
0000000000000000000000101
0000000000000000000000101
0000000000000000000000101
0000000000000000000000101
0000000000000000000000101
1111111111111111111111101
1000000000000000000000001
1111111111111111111111111