0000000000000000000000000
0000000000000000000000000
0000000000000000000000000
0000000000000000000000000
0000000000000000000000000
0000000000000000000000000
0001111110000000000000000
0000000010000111111111000
0000000100000000000100000
0000001000000000001000000
0000001000000000010000000
0000010000000000100000000
0000100000000001100000000
0000100000000011000000000
0001000000000011111111100
0001111111000000000000000
0000000000000000000000000
0000000000000000000000000
0000000000000000000000000
0000000000000000000000000
0000000000000000000000000
0000000000000000000000000
0000000000000000000000000
0000000000000000000000000
0000000000000000000000000